{
  "id": "nexus",
  "name": "The Nexus",
  "tileSize": 16,
  "width": 15,
  "height": 15,
  "spawnX": 7,
  "spawnY": 9,
  "palette": {
    "floor": "#1a0a2e",
    "wall": "#0a0a0a",
    "path": "#2a1a3e",
    "exit": "#00ff88",
    "noiseBase": "#1a0a2e",
    "noiseDrift": "#0a2a2e"
  },
  "layers": [
    {
      "name": "ground",
      "data": [
        0,0,0,0,0,0,0,0,0,0,0,0,0,0,0,
        0,0,0,0,0,0,0,0,0,0,0,0,0,0,0,
        0,0,1,1,1,1,1,1,1,1,1,1,1,0,0,
        0,0,1,2,2,2,2,2,2,2,2,2,1,0,0,
        0,0,1,2,3,3,3,3,3,3,3,2,1,0,0,
        0,0,1,2,3,4,4,4,4,4,3,2,1,0,0,
        0,0,1,2,3,4,5,5,5,4,3,2,1,0,0,
        0,0,1,2,3,4,5,6,5,4,3,2,1,0,0,
        0,0,1,2,3,4,5,5,5,4,3,2,1,0,0,
        0,0,1,2,3,4,4,4,4,4,3,2,1,0,0,
        0,0,1,2,3,3,3,3,3,3,3,2,1,0,0,
        0,0,1,2,2,2,2,2,2,2,2,2,1,0,0,
        0,0,1,1,1,1,1,1,1,1,1,1,1,0,0,
        0,0,0,0,0,0,0,0,0,0,0,0,0,0,0,
        0,0,0,0,0,0,0,0,0,0,0,0,0,0,0
      ]
    },
    {
      "name": "collision",
      "data": [
        1,1,1,1,1,1,1,1,1,1,1,1,1,1,1,
        1,1,1,1,1,1,1,1,1,1,1,1,1,1,1,
        1,1,0,0,0,0,0,0,0,0,0,0,0,1,1,
        1,1,0,0,0,0,0,0,0,0,0,0,0,1,1,
        1,1,0,0,0,0,0,0,0,0,0,0,0,1,1,
        1,1,0,0,0,0,0,0,0,0,0,0,0,1,1,
        1,1,0,0,0,0,0,0,0,0,0,0,0,1,1,
        1,1,0,0,0,0,0,0,0,0,0,0,0,1,1,
        1,1,0,0,0,0,0,0,0,0,0,0,0,1,1,
        1,1,0,0,0,0,0,0,0,0,0,0,0,1,1,
        1,1,0,0,0,0,0,0,0,0,0,0,0,1,1,
        1,1,0,0,0,0,0,0,0,0,0,0,0,1,1,
        1,1,0,0,0,0,0,0,0,0,0,0,0,1,1,
        1,1,1,1,1,1,1,1,1,1,1,1,1,1,1,
        1,1,1,1,1,1,1,1,1,1,1,1,1,1,1
      ]
    }
  ],
  "exits": [
    { "x": 7, "y": 2, "target": "forest", "spawnX": 15, "spawnY": 19 },
    { "x": 7, "y": 12, "target": "wake", "spawnX": 0, "spawnY": 0 }
  ],
  "collectibles": [],
  "npcs": [
    {
      "id": "watcher",
      "personalityId": "watcher",
      "name": "The Watcher",
      "spawnX": 5,
      "spawnY": 5,
      "wanderRadius": 2,
      "interactRadius": 2,
      "stationary": true
    }
  ]
}
